Y                                                                                                                              Z
Y                                                                                                                              Z
Y                                                      NMM    MNMMNN        M       M                                          Z
Y                                                   M    MM             M       N                                              Z
Y                                                M       N                                                                     Z
Y                                        M    M          M                                                                     Z
Y                              M   N  M  MNNNMN          MNNM                                      NM                          Z
Y                          M                             N                                 NMMNM                               Z
Y                       N        M                       N         N  M            N                                           Z
Y                    N                                   MNMMMNNMMNN  NMNMMNMNNNMMNM                   MNMMMN                  Z
Y                 M                N                     N                                                                     Z
YYYYYYYYYYYYYYYY                   NNMMNNMMNMNMMMNNNMNNNNM                                                        ZZZZZZZZZZZZZZ