XOOOOXXXXXXOOOOXXXXXOOOOOOXXXXXXXXXXXXXXXXXXXXXOOOOOOOOOOOOOOOOOOOOOOOOOOOOOOOOOOOOOOOOOOOOOOOOOOOOOOOOOOOOOOOOOOOOOOOOOOOOOOOOX
X                                                                                                                              X
X                                                                                                                              X
X                                                                                                                              X
X                                                                                                                              X
X                                                                                                                              X
X                                                      D  D                                                                    X
X                                                    CC    CC                                       DDD   DDD                  X
X                 D        DDDDD   CC                CC    CC        CCCCCCCC     D          D    DD         DD                X
X       D  D   D   DCDCDCDC          DD            CCC  CC  CCC                    C        C    D             D               X
X      DD  DD       D    D             CC        CCC          CCC   D        D      C      C                      DDDDD        X
DDDDDDDDDOODDDDDDDDDDDDDDDDDDDDDOODDDDDDDDDDDDDDDDDOOOOOOOOOOOODDDDDDOOOOOOOODDDDDDDDDDDDDDDDDDDDDOOOOOOOOOOOOODDDDDDDDDDDDDDDDD