XXXXXXOOOOOOXXXXXXXXXXXXXXXXOOOOOOOOOOOXXXXXXXXXXXXXOOOOOOXXXXXXXXXOOOOXXXXXXXXXXXXXXXXXOOOOOOOOOOOOOOOOOOOOOOOOOOOOOXXXXXXXXXXX
X                                               X                                                                              X
X                                               X                                                                              X
X                                               X                                                                              X
X                                               X                                                     XXXXXX                   X
X                                               X                                                 XX                           X
X                                               XX    DD                          DD  XXXX                                     X
X                        DDDD   DDDD                 D D   DDD  DDD              D            XX                               X
X       D  D         D                 D            D  D                        D    X                                         X
X     D DXXXD    D                                                    DDDDDDD                                                  X
X    D  DXXXXD               DDD                  DD        XXXXXX                                               XXXXX         X
DDDDD   DXXXXXDDDDOODDDDDDDDDDDDDDDDDDDDDDDDDDDDDDDDOOOOOOODDDDDDDDDDOOOOOOOOODDDDDDDDDOOOOOOOOOOOOOOOOOOOODDDDDDDDDDDDDDDDDDDDD