WWWWWWWWWWWWWOOWWWWWWWWWWOOOWWWWWWWWWWWWWWWWWWWWOOOOOWWWWWWOOOOOOWWOOOOWWOOOOOOWWWWWWWWWOOOOOOOOOOWWWWWWWWWWWWWWWWWWOOOOOOOOOOOW
W                                                                                                                              W
W                                                                                                                              W
W                                                                                                                              W
W                                                                                                                              W
W                                                 B       B                                                                    W
W                                         D    D   BBBBBBB                                  BCBBCCB                            W
W            BBB BBBBBBB BB                DCCD     BBBB                                BB   B B B           BBBBB             W
W           BBWW WWWWWWW WCB               DCCD                          B    B   B    BB               BBB                    W
W          BBWWW WWWWWWW WWBB          CD  DCCD              BBBBBB     BBBBBBB   BBBBBB               B B B       AAAA        W
W         BBWWWW WWWWWWB WWWCB         DC DDCCDC             BBBBBB    BABABABA   BABABA              B B B B          AAA     W
ABABBBABABBABBBAOABAABABOBAAAABAABABABABABABBABAOOOOOOOOOOOOOBAOOOBOOOOABABABABOOOAABAABAABBBAOOOOOOBBBBBAAABOOOOOOOOOOOAABABABB