XXXXXXXXXXX     XXXXXXXXXXXX XXXXXXXXXXXXXXXXXX  XXXXXXXXXXXXXXXXXXXX   XXXXXXXXX   XXXXXXXXXXXXXXXXXXXXXXXXX   XXXXXXXXXXXX   X
X                                                                                                                              X
X                                                                                                                              X
X   SS                                                                                                                         X
X   SS                                                                                                                         X
X                                                                                                              D               X
X                                                                XXXX   X       X   X                                          X
X                                                             X      XXX    X    XXX                                           X
X                       D              D      D  D         X          X           X                                            X
X                      DDDDDDDDDDDDDDDDDD      DD       X                                                   D     D            X
XDDDDDDDDD            DDDDDDDDDDDDDDDDDDDD     DD                                 D       DDDDDDDDD        DD     DD           X
XDDDDDDDDDDDDDDDDDDDDDDDDDDDDDDDDDDDDDDDDDDDDDDDDDDDDDDDDDDDDDDDDDDDDDDDDDDDDDDDDDDDDDDDDDDDDDDDDDDDDDDDDDDDDDDDDDDDDDDDDDDDDDDX