X                                                                                                                               
X                                                                                                                              X
X                                                                                                                              X
X                                                                                                                              X
X                                                                                                                              X
X                                                                                        XX                 XXXXXX             X
X                                           XXX           XX                             XX                                    X
X            X   X                    XXX     XX   XXXXXXXX                            XXXX       XX    XX                     X
X         X  XXXXX  X          XX    XX        XXXXX          XX    XX  XX      XX     XXXX    XXX  XXXXX        XX            X
X       XXX         XX      XX  XXXXXX                         XXXXXX    XXXXXXXX    XXXXXX                      XXX           X
X      XXXX         XXX   XX                                    XXXX                 XXXXXX                      XXXX          X
XXXXXXXXXXXOOOOOOOOOXXXXXXXXOOOOOOOOOOOOOOOOOOOOOOOOOOOOOOOOOOOOXXXXOOOOOOOOOOOOOOOOOXXXXXXXXXXXXXXXXXXXXXXXXXXXXXXXXXXXXXXXXXXX