W                                                                                                              ZZZA            W
W                                                                                                                 A            W
W                                                                                                          YY     A            W
W                                                                                                                 A            W
W                                           ZYZYZYZYZYZYZ                                              YY         A            W
W                                                                                                                 A            W
W                                                                                                  YY             A            W
W                 YY          YYYYYYYYYYYY                                                                        A            W
W                 YY           Z        Z                       YY                             YY                 A            W
W             YY  ZZ           Z        Z             Y  Y                                                        A            W
W             YY  ZZ      Y    Z        Z             Y  Y               Y   Y   Y  Y  Y  Y                       A            W
WAABBAABBAABBAAB  ABBAABBAABBAABBAABBAABBAABBAABBAABBAA  AABBAABBAABBAABBA                ABBAABBAABBAABBAABBAABBAABBAABBAABBAAW