W                                                                                                                              W
W                                                                                                                              W
W                    CDDDCCDCDDCCDCD     D                                                                                     W
W                                                                            DD                     C                          W
W                                                                            CD                                                W
W                  D                           D   D                        CCD                DD                              W
W                                             DDDDDDD                        CC                                                W
W                                            DDDDDDDDD                       DCCCD                                             W
W                C                    ZZ      XXXXXXX        CD           DCDCC           CDD                  DCCD            W
W                      D          ZZ  YY      XXXXXXX                        DD                       WWW                      W
W           DD         C          ZZ  ZZ      XXXXXXX                        DC                       WWW                      W
WCCDDCDDDCDDCDCCCDDDDCCCDCDCDCCCCDDDDCDCDDDCDCCCCDCDDCDDDCCCDDDCDCDCDCDCCCDCDCDCDDDCDDDCDDDDDCCCCDDCCCDDDDCCCDDDDCCCDCDCCCCCCDDW