W                                                                                                                              W
W                                                                                                                              W
W                                              NMM            M                                                                W
W                                                NNNNMMNMNNMNMM                                                                W
W                        N M         N                                                                                         W
W                          NMNMMMNMNNN   M    M                                                             NMNNMM             W
W                   NNMN                 MNNNMN                                                                                W
W                                                                                                                              W
W                                                                     M            N             MN   NM  M       W            W
W                MNMMN                                       MNNMMNN  NMNMMNMNNNMMNM      NNMNMN                  W            W
W                                  N                     N   NMNMNMN                 MNMNNNM                      W            W
WWWWWWWWWWWWWWWW                   NNMMNNMMNMNMMMNNNMNNNNM                                                        WWWWWWWWWWWWWW